11111111111111111
11000000000000001
11000000000000001
11000000000000001
11000000000000001
11000000000000001
11000000000000001
1100P100001000001
11000010000000001
11111111111111111